,neighbours_conn,center_conn,close_nodes_ratio,spath_length_avg,ind_dif_avg,spath_ind_dif,ind_spath_ratio,sel_nodes_ratio,cnfname
0,0.08370882149193833,0.08515860530201183,0.9953905464297688,11,31578,31567,2870,0.5,sc14-app_train_preprocessed/openstacks-sequencedstrips-nonadl-nonnegated-os-sequencedstrips-p30_1.025-NOTKNOWN_preprocessed.cnf
0,0.11175730319828614,0.14128282103575354,0.9982434127979924,2,8014,8012,4007,0.5,sc14-app_train_preprocessed/7pipe_k_preprocessed.cnf
0,0.12842824644603262,0.12235040616149655,0.9996957480794098,8,8617,8609,1077,0.5,sc14-app_train_preprocessed/bob12s02_preprocessed.cnf
0,0.10251621316186882,0.1000605088105,1.0,1,193,192,193,0.5,sc14-app_train_preprocessed/complete-300-0.1-7-9876543213007_preprocessed.cnf
0,0.12031007022680858,0.219328194894882,0.8447869446962829,4,10939,10935,2734,0.5,sc14-app_train_preprocessed/q_query_3_l46_lambda_preprocessed.cnf
0,0.11149316379355532,0.10333854748731834,0.9925141743444366,14,60297,60283,4306,0.5,sc14-app_train_preprocessed/dated-10-13-u_preprocessed.cnf
0,0.12808039510305114,0.12206584577325127,0.9897852905097324,14,85918,85904,6137,0.5,sc14-app_train_preprocessed/UR-20-10p1_preprocessed.cnf
0,0.11173892267773328,0.09816558416154468,0.9985762729414202,6,25749,25743,4291,0.5,sc14-app_train_preprocessed/AProVE09-06_preprocessed.cnf
0,0.13989001342105653,0.15458484357179772,0.9164979757085021,7,10469,10462,1495,0.5,sc14-app_train_preprocessed/gss-22-s100_preprocessed.cnf
0,0.11465019093222645,0.09315126427981417,0.998741346758968,6,3172,3166,528,0.5,sc14-app_train_preprocessed/MD5-32-5_preprocessed.cnf
0,0.13289678568658575,0.14326603002647184,0.942390369733448,14,6059,6045,432,0.5,sc14-app_train_preprocessed/countbitssrl032_preprocessed.cnf
0,0.1276844585221098,0.12166799810625654,0.9898756482290112,14,86949,86935,6210,0.5,sc14-app_train_preprocessed/UR-20-10p0_preprocessed.cnf
0,0.13930785414119706,0.15358374697588728,0.9168499780026396,7,10586,10579,1512,0.5,sc14-app_train_preprocessed/gss-24-s100_preprocessed.cnf
0,0.11442168999706916,0.09205430278405057,0.999033349444176,6,2739,2733,456,0.5,sc14-app_train_preprocessed/MD5-28-3_preprocessed.cnf
0,0.1263956907784125,0.11315212345326126,0.9998508353221957,4,4503,4499,1125,0.5,sc14-app_train_preprocessed/001-80-12_preprocessed.cnf
0,0.1443497243149729,0.16405388471177934,1.0,1,137,136,137,0.5,sc14-app_train_preprocessed/stable-400-0.1-11-98765432140011_preprocessed.cnf
0,0.1064340095464458,0.10321354621577987,0.9944852941176472,4,5055,5051,1263,0.5,sc14-app_train_preprocessed/ctl_4291_567_5_unsat_pre_preprocessed.cnf
0,0.0967144919166207,0.1924497206029632,0.7718120805369127,2,747,745,373,0.5,sc14-app_train_preprocessed/rpoc_xits_15_SAT_preprocessed.cnf
0,0.12753916233428775,0.1229931482693486,0.9770056533062312,6,10377,10371,1729,0.5,sc14-app_train_preprocessed/6s16_preprocessed.cnf
0,0.1263956907784125,0.11315212345326126,0.9998508353221957,4,4526,4522,1131,0.5,sc14-app_train_preprocessed/006-80-4_preprocessed.cnf
0,0.13206231620287395,0.10425105819485506,0.996663040422437,25,54850,54825,2194,0.5,sc14-app_train_preprocessed/hwmcc10-timeframe-expansion-k45-pdtvisns3p02-tseitin_preprocessed.cnf
0,0.13240960850139116,0.13692981065683926,0.9706896551724138,6,1541,1535,256,0.5,sc14-app_train_preprocessed/6s167-opt_preprocessed.cnf
0,0.10209704402694562,0.09954090899347047,1.0,1,277,276,277,0.5,sc14-app_train_preprocessed/complete-400-0.1-7-9876543214007_preprocessed.cnf
0,0.10190181481779713,0.0994604104709425,1.0,1,284,283,284,0.5,sc14-app_train_preprocessed/complete-400-0.1-16-98765432140016_preprocessed.cnf
0,0.11439384072208195,0.0933968776657343,0.9993016759776536,6,2848,2842,474,0.5,sc14-app_train_preprocessed/MD5-29-3_preprocessed.cnf
0,0.11430119234444636,0.09367456163666953,0.9986525937570178,6,2903,2897,483,0.5,sc14-app_train_preprocessed/MD5-30-1_preprocessed.cnf
0,0.1293717482587041,0.17049240935162965,0.9160628479902372,17,17467,17450,1027,0.5,sc14-app_train_preprocessed/IBM_FV_2004_rule_batch_1_31_1_SAT_dat.k40.debugged_preprocessed.cnf
0,0.14389522414004766,0.15554131080913233,1.0,1,391,390,391,0.5,sc14-app_train_preprocessed/vmpc_33_preprocessed.cnf
0,0.10235509708112528,0.1000097352864416,1.0,1,205,204,205,0.5,sc14-app_train_preprocessed/complete-300-0.1-4-9876543213004_preprocessed.cnf
0,0.11186015710994704,0.10343962321332324,0.9920403682121444,14,63661,63647,4547,0.5,sc14-app_train_preprocessed/partial-10-11-s_preprocessed.cnf
0,0.0999364824993176,0.22464886505167336,0.7089201877934272,2,404,402,202,0.5,sc14-app_train_preprocessed/rbcl_xits_08_UNSAT_preprocessed.cnf
0,0.07629247493510558,0.07942591093908734,0.999852556305061,8,17860,17852,2232,0.5,sc14-app_train_preprocessed/minxor128_preprocessed.cnf
0,0.11180124472125434,0.11205856227468666,0.990589733611632,7,18798,18791,2685,0.5,sc14-app_train_preprocessed/atco_enc2_opt1_05_21_preprocessed.cnf
0,0.13225162559093834,0.10654023339984203,1.0,20,46240,46220,2312,0.5,sc14-app_train_preprocessed/pb_300_10_lb_07_preprocessed.cnf
0,0.1157528170127135,0.09347929761886606,0.9982425307557118,6,2595,2589,432,0.5,sc14-app_train_preprocessed/MD5-27-4_preprocessed.cnf
0,0.10413873738990284,0.10490501626324937,0.9800053319114904,5,2514,2509,502,0.5,sc14-app_train_preprocessed/AProVE07-01_preprocessed.cnf
0,0.1263956907784125,0.11315212345326126,0.9998508353221957,4,4398,4394,1099,0.5,sc14-app_train_preprocessed/002-80-12_preprocessed.cnf
0,0.11473251520271024,0.09259949266729693,0.9983095870562666,6,2839,2833,473,0.5,sc14-app_train_preprocessed/MD5-28-1_preprocessed.cnf
0,0.11208776709402797,0.08477556629394532,0.972206625491297,6,33709,33703,5618,0.5,sc14-app_train_preprocessed/aaai10-planning-ipc5-TPP-21-step11_preprocessed.cnf
0,0.11087596653078399,0.10403270762255694,0.9942607119646306,14,72894,72880,5206,0.5,sc14-app_train_preprocessed/partial-5-15-s_preprocessed.cnf
0,0.1007900156628107,0.1167951538264066,0.99881321289642,2,50474,50472,25237,0.5,sc14-app_train_preprocessed/velev-vliw-uns-2.0-uq5_preprocessed.cnf
0,0.1263956907784125,0.11315212345326126,0.9998508353221957,4,4537,4533,1134,0.5,sc14-app_train_preprocessed/005-80-12_preprocessed.cnf
0,0.1312611905591488,0.1273905353684909,0.9766111425568044,27,32722,32695,1211,0.5,sc14-app_train_preprocessed/hwmcc10-timeframe-expansion-k45-pdtpmsgoodbakery-tseitin_preprocessed.cnf
0,0.12792690949383814,0.1194227356259284,0.9916202518942244,13,66208,66195,5092,0.5,sc14-app_train_preprocessed/UR-15-10p0_preprocessed.cnf
0,0.1322696271729605,0.104648670791363,0.9966725941764945,26,61033,61007,2347,0.5,sc14-app_train_preprocessed/hwmcc10-timeframe-expansion-k50-pdtvisns3p00-tseitin_preprocessed.cnf
0,0.11482180017776247,0.09383783758613656,0.9991323210412149,6,3126,3120,521,0.5,sc14-app_train_preprocessed/MD5-31-5_preprocessed.cnf
0,0.1263956907784125,0.11315212345326126,0.9998508353221957,4,4244,4240,1061,0.5,sc14-app_train_preprocessed/004-80-8_preprocessed.cnf
0,0.1099586316650427,0.14567377880126142,0.9971482347573148,2,11696,11694,5848,0.5,sc14-app_train_preprocessed/8pipe_k_preprocessed.cnf
0,0.1443520660613565,0.1635142543859648,1.0,1,125,124,125,0.5,sc14-app_train_preprocessed/stable-400-0.1-12-98765432140012_preprocessed.cnf
0,0.13015403152135058,0.12304837539646207,0.9916633584755856,15,28671,28656,1911,0.5,sc14-app_train_preprocessed/6s153_preprocessed.cnf
0,0.1263956907784125,0.11315212345326126,0.9998508353221957,4,4482,4478,1120,0.5,sc14-app_train_preprocessed/007-80-8_preprocessed.cnf
0,0.09626883219904253,0.06199932415564929,0.9962121212121212,4,155,151,38,0.5,sc14-app_train_preprocessed/aes_32_2_keyfind_1_preprocessed.cnf
0,0.10998679617348826,0.09481803030118313,0.9261860174781524,9,8492,8483,943,0.5,sc14-app_train_preprocessed/aaai10-planning-ipc5-pathways-13-step17_preprocessed.cnf
0,0.10819767332775647,0.09471800925307086,0.9227892915390428,10,16920,16910,1692,0.5,sc14-app_train_preprocessed/aaai10-planning-ipc5-pathways-17-step20_preprocessed.cnf
0,0.12916022106857028,0.12299355993240732,0.9996191346739792,8,8415,8407,1051,0.5,sc14-app_train_preprocessed/bob12m02-opt_preprocessed.cnf
0,0.12706327029411973,0.12055250681213965,0.9902501949961,15,66266,66251,4417,0.5,sc14-app_train_preprocessed/UCG-15-10p1_preprocessed.cnf
0,0.1263956907784125,0.11315212345326126,0.9998508353221957,4,4495,4491,1123,0.5,sc14-app_train_preprocessed/007-80-12_preprocessed.cnf
0,0.13975921707373834,0.15396686509774868,0.9190578974098528,7,10290,10283,1470,0.5,sc14-app_train_preprocessed/gss-20-s100_preprocessed.cnf
0,0.13059809100906308,0.1436034591123817,0.9514012061014544,6,1931,1925,321,0.5,sc14-app_train_preprocessed/6s168-opt_preprocessed.cnf
0,0.1263956907784125,0.11315212345326126,0.9998508353221957,4,4518,4514,1129,0.5,sc14-app_train_preprocessed/008-80-8_preprocessed.cnf
0,0.10215479215913573,0.0996489866420116,1.0,1,323,322,323,0.5,sc14-app_train_preprocessed/complete-400-0.1-3-9876543214003_preprocessed.cnf
0,0.1270527316361124,0.12109808623021663,0.9893060012623008,15,75074,75059,5004,0.5,sc14-app_train_preprocessed/UCG-20-5p1_preprocessed.cnf
0,0.10029922985410077,0.11592323854764268,0.998302111041938,2,35313,35311,17656,0.5,sc14-app_train_preprocessed/9dlx_vliw_at_b_iq4_preprocessed.cnf
0,0.11156751787656537,0.10541819926050074,0.9930962873719921,14,84676,84662,6048,0.5,sc14-app_train_preprocessed/partial-5-17-s_preprocessed.cnf
0,0.1448901683322169,0.16237179900505322,1.0,1,309,308,309,0.5,sc14-app_train_preprocessed/vmpc_29_preprocessed.cnf
0,0.09877433439338572,0.18076808808051864,0.7927927927927928,2,773,771,386,0.5,sc14-app_train_preprocessed/rbcl_xits_14_SAT_preprocessed.cnf
0,0.12034288611121972,0.21973496204430126,0.8447112706566813,4,10863,10859,2715,0.5,sc14-app_train_preprocessed/q_query_3_l45_lambda_preprocessed.cnf
0,0.08345354850457097,0.08429847017199213,0.9949924572577942,11,31860,31849,2896,0.5,sc14-app_train_preprocessed/openstacks-sequencedstrips-nonadl-nonnegated-os-sequencedstrips-p30_3.025-NOTKNOWN_preprocessed.cnf
0,0.132887119096952,0.1157548303742087,0.9717912552891396,6,951,945,158,0.5,sc14-app_train_preprocessed/dimacs_preprocessed.cnf
0,0.11409177511819465,0.09311679034240414,0.9990689013035382,6,2871,2865,478,0.5,sc14-app_train_preprocessed/MD5-29-5_preprocessed.cnf
0,0.14436401478465696,0.16232502425435014,1.0,1,109,108,109,0.5,sc14-app_train_preprocessed/stable-300-0.1-20-98765432130020_preprocessed.cnf
0,0.1018944489057414,0.09932562163392547,1.0,1,330,329,330,0.5,sc14-app_train_preprocessed/complete-500-0.1-1-9876543215001_preprocessed.cnf
0,0.10420214404836804,0.09867314269281813,0.9910615276050944,8,20012,20004,2501,0.5,sc14-app_train_preprocessed/atco_enc1_opt1_05_21_preprocessed.cnf
0,0.13915223505060298,0.15317869353845842,0.9194554014505664,7,10691,10684,1527,0.5,sc14-app_train_preprocessed/gss-19-s100_preprocessed.cnf
0,0.1263627873402321,0.11888726854802438,1.0,5,1178,1173,235,0.5,sc14-app_train_preprocessed/6s165-nonopt_preprocessed.cnf
0,0.07930755705710417,0.034572473982391154,1.0,4,171,167,42,0.5,sc14-app_train_preprocessed/aes_24_4_keyfind_5_preprocessed.cnf
0,0.14434517073265005,0.1651027255639097,1.0,1,118,117,118,0.5,sc14-app_train_preprocessed/stable-400-0.1-2-9876543214002_preprocessed.cnf
0,0.12558421313915455,0.12082691919132267,0.990341970379682,66,74928,74862,1135,0.5,sc14-app_train_preprocessed/UTI-20-5p1_preprocessed.cnf
0,0.13605493873161578,0.12353794452442535,0.9910266414000668,29,11812,11783,407,0.5,sc14-app_train_preprocessed/6s151_preprocessed.cnf
0,0.1263956907784125,0.11315212345326126,0.9998508353221957,4,4576,4572,1144,0.5,sc14-app_train_preprocessed/002-80-4_preprocessed.cnf
0,0.12964676108869902,0.12995445008139322,0.9953172205438068,6,4417,4411,736,0.5,sc14-app_train_preprocessed/maxxor032_preprocessed.cnf
0,0.11354976362713545,0.09064024427452698,0.999034049746438,6,2854,2848,475,0.5,sc14-app_train_preprocessed/MD5-28-4_preprocessed.cnf
0,0.11102311751718208,0.1027599885636256,0.9922725986702504,14,75220,75206,5372,0.5,sc14-app_train_preprocessed/total-10-13-u_preprocessed.cnf
0,0.11930856716057615,0.12133497859402778,0.9717514124293786,4,228,224,57,0.5,sc14-app_train_preprocessed/aes_32_3_keyfind_1_preprocessed.cnf
0,0.11493091913582212,0.09194502937081699,0.9995970089105808,7,44732,44725,6390,0.5,sc14-app_train_preprocessed/c10bi_i_preprocessed.cnf
0,0.12659110544563626,0.12025861907963002,0.9891808346213292,16,86206,86190,5387,0.5,sc14-app_train_preprocessed/UCG-20-10p0_preprocessed.cnf
